key	value
{emp_swordsmen}	검병
{emp_flagellants}	고행단
{emp_ror_handgunners_gunderman_full}	군더만의 명사수 (소총병)
{emp_ror_handgunners_gunderman}	군더만의 명사수
{all_archers}	궁병
{emp_pistoliers}	권총 기병대
{emp_ror_pistoliers_full}	귀족 자제 파견대 (권총 기병대)
{emp_ror_pistoliers}	귀족 자제 파견대
{emp_ror_halberdiers_full}	노르틀란트 선원들 (미늘창병)
{emp_ror_halberdiers}	노르틀란트 선원들
{emp_ror_flagellants_full}	누더기영혼 (고행단)
{emp_ror_flagellants}	누더기영혼
{emp_knights_of_the_blazing_sun}	눈부신 태양 기사
{emp_greatswords}	대검병
{emp_great_cannons}	대구경 대포
{emp_arch_lector}	대학자
{emp_demigryph_knights}	데미그리프 기사
{emp_demigryph_knights_halberds}	데미그리프 기사 (미늘창)
{emp_reiksguard}	라익스가드
{emp_ror_great_cannons_full}	마녀들의 망치 (대구경 대포)
{emp_ror_great_cannons}	마녀들의 망치
{emp_markus_wulfhart}	마르쿠스 불프하르트
{emp_ror_empire_knights_morr_full}	모르 기사 (제국 기사)
{emp_halberdiers}	미늘창병
{all_mortars}	박격포
{emp_balthasar_gelt}	발타자르 겔트
{emp_ror_outriders_grenade_launcher_full}	변경군 (선임 총기병대 - 유탄 발사기)
{emp_boris_todbringer}	보리스 토드브링거
{emp_bright_wizard}	불의 마법사
{emp_light_wizard}	빛의 마법사
{emp_crossbowmen}	석궁병
{emp_outriders_grenade_launcher}	선임 총기병대 (유탄 발사기)
{emp_outriders}	선임 총기병대
{emp_handgunners}	소총병
{emp_huntsmen}	수렵단
{emp_huntsmen_general}	수렵단장
{emp_ror_mortars_full}	수트손 포대 (박격포)
{emp_ror_mortars}	수트손 포대
{emp_ror_crossbowmen_full}	슈티르 강 순찰대 (석궁병)
{emp_ror_crossbowmen}	슈티르 강 순찰대
{emp_ror_free_company_militia_full}	슈티를란트의 복수 (용병대)
{emp_ror_free_company_militia}	슈티를란트의 복수
{emp_ror_spearmen_shields_full}	엘드레드 근위대 (창병 - 방패)
{emp_ror_empire_knights_light_full}	영원한 빛의 기사 (제국 기사)
{emp_ror_empire_knights_light}	영원한 빛의 기사
{emp_jade_wizard}	옥색 마법사
{emp_ror_demigriph_knights_full}	왕실 알트도르프 그리폰 기사 (데미그리프 기사)
{emp_ror_demigriph_knights}	왕실 알트도르프 그리폰 기사
{emp_free_company_militia}	용병대
{emp_ror_swordsmen_ulric_full}	울릭의 검 (검병)
{emp_ror_swordsmen_ulric}	울릭의 검
{emp_ror_handgunners_silver_full}	은총탄 (소총병)
{emp_ror_handgunners_silver}	은총탄
{emp_volkmar_the_grim}	음침한 볼크마
{emp_witch_hunter}	이단사냥꾼
{emp_amethyst_wizard}	자수정 마법사
{emp_war_wagons}	전쟁 마차
{emp_war_wagons_mortars}	전쟁 마차 (박격포)
{emp_warrior_priest}	전투 사제
{emp_empire_knights}	제국 기사
{emp_empire_captain}	제국 부대장
{emp_general_of_the_empire}	제국의 장수
{emp_ror_archers_full}	죽음의 사수 (궁병)
{emp_ror_archers}	죽음의 사수
{emp_steam_tank}	증기 전차
{emp_ror_swordsmen_sigmar_full}	지그마의 자손 (검병)
{emp_ror_swordsmen_sigmar}	지그마의 자손
{emp_ror_reiksguard_full}	진틀러의 라익스가드 (라익스가드)
{emp_ror_reiksguard}	진틀러의 라익스가드
{all_spearmen}	창병
{all_spearmen_shields}	창병 (방패)
{emp_celestial_wizard}	천상 마법사
{emp_ror_greatswords_full}	카로부르크 대검병 (대검병)
{emp_ror_greatswords}	카로부르크 대검병
{emp_karl_franz}	카를 프란츠
{emp_ror_helstorm_rocket_battery_full}	태양의 광포 (헬스톰 로켓 포대)
{emp_ror_helstorm_rocket_battery}	태양의 광포
{emp_ror_luminark_of_hysh_full}	템플레호프 광궤 (히쉬의 광궤)
{emp_ror_luminark_of_hysh}	템플레호프 광궤
{emp_ror_huntsmen_full}	하얀 늑대들 (수렵단)
{emp_ror_huntsmen}	하얀 늑대들
{emp_helblaster_volley_guns}	헬블래스터 다연장 포대
{emp_helstorm_rocket_battery}	헬스톰 로켓 포대
{emp_amber_wizard}	호박 마법사
{emp_ror_empire_knights_greatswords_full}	황소고집 (제국 기사 - 대검)
{emp_ror_empire_knights_greatswords}	황소고집
{emp_ror_steam_tank_full}	황제의 분노 (증기 전차)
{emp_ror_steam_tank}	황제의 분노
{emp_grey_wizard}	회색 마법사
{emp_ror_war_wagons_helblasters_full}	흑사자 (전쟁 마차 - 헬블래스터)
{emp_ror_war_wagons_helblasters}	흑사자
{emp_luminark_of_hysh}	히쉬의 광궤
{dwf_giant_slayers}	거인 척살단
{dwf_ror_grudge_throwers_full}	고블린 발사기 (원한 발사기)
{dwf_ror_grudge_throwers}	고블린 발사기
{dwf_miners}	광부
{dwf_miners_blasting_charges}	광부 (폭발 화약)
{dwf_lord}	군주
{dwf_longbeards}	긴수염
{dwf_longbeards_great_weapons}	긴수염 (대형 무기)
{dwf_ror_ironbreakers_full}	노르그림 일족 철쇄대 (철쇄대)
{dwf_ror_ironbreakers}	노르그림 일족 철쇄대
{dwf_bolt_throwers}	노포
{dwf_cannons}	대포
{dwf_dwarf_warriors}	드워프 전사
{dwf_dwarf_warriors_great_weapons}	드워프 전사 (대형 무기)
{dwf_runelord}	룬 군주
{dwf_runesmith}	룬 장인
{dwf_hammerers}	망치대
{dwf_yoked_carnosaur}	멍에 채운 카르노사우루스
{dwf_bugmans_rangers}	버그만의 순찰자
{dwf_belegar_ironhammer}	벨레가르 아이언해머
{dwf_ror_hammerers_full}	봉우리 관문 보초 (망치대)
{dwf_ror_hammerers}	봉우리 관문 보초
{dwf_master_engineer}	선임 기술자
{dwf_thorek_ironbrow}	소렉 아이언브로우
{dwf_quarrellers}	쇠뇌수
{dwf_quarrellers_great_weapons}	쇠뇌수 (대형 무기)
{all_rangers}	순찰자
{dwf_rangers_great_weapons}	순찰자 (대형 무기)
{dwf_ror_miners_blasting_charges_full}	에크룬드 광부 (광부 - 폭약)
{dwf_ror_miners_blasting_charges}	에크룬드 광부
{dwf_organ_guns}	오르간 포
{dwf_ror_slayers_full}	용등골 척살단 (척살단)
{dwf_ror_slayers}	용등골 척살단
{dwf_ror_dwarf_warriors_full}	용숨결 오솔길의 전사들 (드워프 전사)
{dwf_ror_dwarf_warriors}	용숨결 오솔길의 전사들
{dwf_thunderers}	우레수
{dwf_ror_rangers_great_weapons_full}	울타르의 습격대 (순찰자 - 대형 무기)
{dwf_ror_rangers_great_weapons}	울타르의 습격대
{dwf_ungrim_ironfist}	웅그림 아이언피스트
{dwf_grudge_throwers}	원한 발사기
{dwf_ror_irondrakes_full}	응징대 (철룡대)
{dwf_ror_irondrakes}	응징대
{dwf_gyrobomber}	자이로봄버
{dwf_gyrocopter}	자이로콥터
{dwf_gyrocopter_brimstone_gun}	자이로콥터 (유황포)
{dwf_ancestor_spirit}	조상의 영혼
{dwf_thane}	종사
{dwf_high_runelord}	지고 룬 군주
{dwf_slayers}	척살단
{dwf_irondrakes}	철룡대
{dwf_irondrakes_trollhammer_torpedo}	철룡대 (트롤망치 어뢰)
{dwf_ironbreakers}	철쇄대
{dwf_thorgrim_grudgebearer}	토그림 그루지베어러
{dwf_ror_gyrobomber_full}	하늘망치 (자이로봄버)
{dwf_ror_gyrobomber}	하늘망치
{dwf_grombrindal_the_white_dwarf}	하얀 드워프 그롬브린달
{dwf_ror_longbeards_great_weapons_full}	해묵은 원한 근위대 (긴수염 - 대형 무기)
{dwf_ror_longbeards_great_weapons}	해묵은 원한 근위대
{dwf_flame_cannons}	화염포
{dwf_hold}	아성
{dwf_slayer_king}	척살왕
{dwf_slayer_crown}	척살왕관
{dwf_high_king}	제왕
{vmp_great_necromancer}	대강령술사
{vmp_master_necromancer}	강령 달인
{vmp_necromancer}	강령술사
{vmp_fell_bats}	거대 박쥐
{vmp_black_coach}	검은 마차
{vmp_ror_dire_wolves_full}	굶주린 무리 (흉폭한 늑대)
{vmp_ror_dire_wolves}	굶주린 무리
{vmp_ror_mortis_engine_full}	나가쉬의 발톱 (필멸의 제단)
{vmp_ror_mortis_engine}	나가쉬의 발톱
{vmp_ror_grave_guard_full}	냉엄대 (묘지 근위대)
{vmp_ror_grave_guard}	냉엄대
{vmp_necrarch_vampire_lord}	네크라치 뱀파이어 군주
{vmp_lahmian_vampire_lord}	라미아 뱀파이어 군주
{vmp_mannfred_von_carstien}	만프레드 폰 카르슈타인
{vmp_wight_king}	망령왕
{vmp_grave_guard}	묘지 근위대
{vmp_grave_guard_great_weapons}	묘지 근위대 (대형 무기)
{vmp_crypt_horror}	무덤의 공포
{vmp_crypt_ghouls}	무덤의 시귀
{vmp_vargheists}	바르가이스트
{vmp_varghulf}	바르굴프
{vmp_banshee}	밴시
{vmp_vampire_lord}	뱀파이어 군주
{vmp_vampire_shadows}	뱀파이어 (그림자)
{vmp_vampire_death}	뱀파이어 (죽음)
{vmp_ror_black_knights_lances_and_barding_full}	베렉의 약탈자 (흑기사 - 마창과 마갑)
{vmp_ror_black_knights_lances_and_barding}	베렉의 약탈자
{vmp_red_duke}	붉은 공작
{vmp_vlad_von_carstein}	블라드 폰 카르슈타인
{vmp_blood_dragon_vampire_lord}	블러드 드래곤 뱀파이어 군주
{vmp_cairn_wraiths}	비석의 망령
{vmp_ror_hexwraiths_full}	서늘한 소름 (저주의 망령)
{vmp_ror_hexwraiths}	서늘한 소름
{vmp_ror_vargheists_full}	슈바르츠하펜의 악마들 (바르가이스트)
{vmp_ror_vargheists}	슈바르츠하펜의 악마들
{vmp_strigoi_vampire_lord}	스트리고이 뱀파이어 군주
{vmp_strigoi_ghoul_king}	스트리고이 시귀 왕
{vmp_zombie_dragon}	시체룡
{vmp_corpse_cart}	시체 수레
{vmp_corpse_cart_unholy_lodestone}	시체 수레 (불경한 자철석)
{vmp_corpse_cart_balefire}	시체 수레 (화톳불)
{vmp_ror_zomble_full}	신의 제물 (좀비)
{vmp_ror_zomble}	신의 제물
{vmp_abyssal_shrieker}	심연의 비명
{vmp_isabella_von_carstein}	이자벨라 폰 카르슈타인
{vmp_hexwraiths}	저주의 망령
{vmp_zomble}	좀비
{vmp_sylvania}	쥘파니아
{vmp_sylvanian_crossbowmen}	쥘파니아 석궁병
{vmp_sylvanian_handgunners}	쥘파니아 소총병
{vmp_ror_skeleton_warriors_full}	쾨니히슈타인의 추적자 (해골 전사)
{vmp_ror_skeleton_warriors}	쾨니히슈타인의 추적자
{vmp_krell}	크렐
{vmp_terrorgheist}	테러가이스트
{vmp_von_carstien_vampire_lord}	폰 카르슈타인 뱀파이어 군주
{vmp_mortis_engine}	필멸의 제단
{vmp_heinrich_kemmler}	하인리히 케믈러
{vmp_skeleton_warriors}	해골 전사
{vmp_skeleton_spearmen}	해골 창병
{vmp_helman_ghorst}	헬만 고스트
{vmp_blood_knights}	혈기사
{vmp_ror_crypt_ghouls_full}	황혼의 포식자 (무덤의 시귀)
{vmp_dire_wolves}	흉폭한 늑대
{vmp_black_knights}	흑기사
{vmp_black_knights_lances_and_barding}	흑기사 (마창과 마갑)
{grn_armored_squig_hoppers}	갑옷 입은 스퀴그 기수
{grn_river_trolls}	강가 트롤
{grn_river_troll_hag}	강가 트롤 마녀
{grn_giant_river_troll_hag}	거대한 강가 트롤 마녀
{grn_spider_hatchlings}	거미 유충
{all_giant}	거인
{grn_black_orcs}	검은 오크
{grn_black_orc_big_boss}	검은 오크 빅 보스
{grn_goblin_archers}	고블린 궁수
{grn_goblin_wolf_rider_archers}	고블린 늑대 궁병 기수
{grn_goblin_wolf_riders}	고블린 늑대 기수
{grn_goblin_wolf_chariots}	고블린 늑대 전차
{grn_goblin_great_shaman}	고블린 대무당
{grn_goblin_big_boss}	고블린 빅 보스
{grn_goblin_rock_lobbers}	고블린 투석기
{grn_ror_goblin_rock_lobbers_full}	고크의 망치 (고블린 투석기)
{grn_ror_goblin_rock_lobbers}	고크의 망치
{grn_grimgor_ironhide}	그림고어 아이언하이드
{grn_ror_forest_goblin_spider_rider_archers_full}	기어오는 주금 (숲 고블린 거미 궁병 기수)
{grn_ror_forest_goblin_spider_rider_archers}	기어오는 주금
{grn_ror_night_goblin_archers_full}	녹슨 화살 (밤 고블린 궁수)
{grn_ror_night_goblin_archers}	녹슨 화살
{grn_ror_river_trolls_full}	늪지의 괴물 (강가 트롤)
{grn_ror_river_trolls}	늪지의 괴물
{grn_ror_goblin_wolf_riders_full}	달울음꾼 (고블린 늑대 기수)
{grn_ror_goblin_wolf_riders}	달울음꾼
{grn_ror_rogue_idol_full}	대빵 큰 놈 (악의 우상)
{grn_ror_rogue_idol}	대빵 큰 놈
{grn_ror_night_goblin_squig_hoppers_full}	더킷의 스퀴그 (밤 고블린 스퀴그 기수)
{grn_ror_night_goblin_squig_hoppers}	더킷의 스퀴그
{grn_stone_trolls}	돌 트롤
{grn_ror_snotling_pump_wagons_full}	로기 보기의 포자기관차 (스노틀링 유압 수레)
{grn_ror_snotling_pump_wagons}	로기 보기의 포자기관차
{grn_ror_goblin_wolf_archers_full}	모그럽의 누더기 약탈단 (고블린 늑대 궁수)
{grn_ror_goblin_wolf_archers}	모그럽의 누더기 약탈단
{grn_shaman}	무당
{grn_blorgar_the_mad_titan}	미친 타이탄 블로르가르
{grn_night_goblins}	밤 고블린
{grn_night_goblins_fanatics}	밤 고블린 (광기)
{grn_night_goblin_archers}	밤 고블린 궁수
{grn_night_goblin_archers_fanatics}	밤 고블린 궁수 (광기)
{grn_night_goblin_shaman}	밤 고블린 무당
{grn_night_goblin_squig_hoppers}	밤 고블린 스퀴그 기수
{grn_night_goblin_warboss}	밤 고블린 전쟁보스
{grn_grom_the_paunch}	배불뚝이 그롬
{grn_brood_queen}	번식 여왕
{grn_ror_orc_boar_boy_big_uns_full}	부러진 엄니 무리 (오크 빅'언 멧돼지 기수)
{grn_ror_orc_boar_boy_big_uns}	부러진 엄니 무리
{grn_nasty_skullkers}	비열한 잠복꾼
{grn_big_uns}	빅'언
{grn_soopa_squig}	수파 스퀴그!
{grn_forest_goblin_spider_rider_archers}	숲 고블린 거미 궁병 기수
{grn_forest_goblin_spider_riders}	숲 고블린 거미 기수
{grn_snotling_pump_wagons}	스노틀링 유압 수레
{grn_snotling_pump_wagons_spikey_rollers}	스노틀링 유압 수레 (가시 밀대)
{grn_snotling_pump_wagons_flappas}	스노틀링 유압 수레 (파닥이)
{grn_skarsnik}	스카스닉
{grn_squig_herd}	스퀴그 무리
{grn_ror_black_orcs_full}	시뻘건 살육광 (블랙 오크)
{grn_ror_black_orcs}	시뻘건 살육광
{grn_arachnarok_spider}	아라크나록 거미
{grn_ror_arachnarok_spider_full}	아라크나록 여왕 (아라크나록 거미)
{grn_ror_arachnarok_spider}	아라크나록 여왕
{grn_rogue_idol}	악의 우상
{grn_savage_orcs}	야만 오크
{grn_savage_orc_boar_boyz}	야만 오크 멧돼지 기수
{grn_savage_orc_big_uns}	야만 오크 빅'언
{grn_savage_orc_boar_boy_big_uns}	야만 오크 빅'언 멧돼지 기수
{grn_savage_orc_arrer_boyz}	야만 오크 활잽이
{grn_feral_wyvern}	야생 와이번
{grn_feral_hydra}	야생 히드라
{grn_ror_night_goblins_fanatics_full}	여덟 봉우리 미치광이 (밤 고블린 - 광신)
{grn_ror_night_goblins_fanatics}	여덟 봉우리 미치광이
{grn_orc_boar_boyz}	오크 멧돼지 기수
{grn_orc_boar_chariots}	오크 멧돼지 전차
{grn_orc_shaman}	오크 무당
{grn_orc_big_uns}	오크 빅'언
{grn_orc_boar_boy_big_uns}	오크 빅'언 멧돼지 기수
{grn_orc_warboss}	오크 전쟁보스
{grn_orc_boyz}	오크 졸개
{grn_orc_arrer_boyz}	오크 활잽이
{grn_lava_spider_rider_archers}	용암 거미 궁수
{grn_lava_arachnarok_spider}	용암 아라크나록 거미
{grn_wurrzag}	우르자그
{grn_ror_goblin_wolf_chariots_full}	이빨 뱉개 (고블린 늑대 전차)
{grn_ror_goblin_wolf_chariots}	이빨 뱉개
{grn_ror_night_goblins_full}	전쟁군주의 졸개들 (밤 고블린)
{grn_ror_night_goblins}	전쟁군주의 졸개들
{grn_warboss}	전쟁보스
{grn_doom_diver_catapults}	파멸의 비행사 발사대
{grn_azhag_the_slaughterer}	학살자 아자그
{brt_lord}	군주
{brt_peasant_bowmen}	농민 궁수
{brt_peasant_bowmen_fire_arrows}	농민 궁수 (불화살)
{brt_peasant_bowmen_pox_arrows}	농민 궁수 (천연두 화살)
{brt_peasant_mob}	농민 무리
{brt_ror_battle_pilgrims_full}	라 메종타알의 신성 감시자 (전투 순례자)
{brt_ror_battle_pilgrims}	라 메종타알의 신성 감시자
{brt_king_louen_leoncoeur}	루앙 레옹쿠르 왕
{brt_repanse_de_lyonesse}	리용세의 르팡스
{brt_ror_mounted_yeomen_archers_full}	몽포르의 감시자 (요먼 기마 궁수)
{brt_ror_mounted_yeomen_archers}	몽포르의 감시자
{brt_men_at_arms}	무장병
{brt_men_at_arms_polearm}	무장병 (도끼창)
{brt_men_at_arms_shields}	무장병 (방패)
{brt_spearmen_at_arms}	무장창병
{brt_spearmen_at_arms_shields}	무장창병 (방패)
{brt_ror_foot_squires_full}	바스통의 짐승사냥꾼 (보행 종자)
{brt_ror_foot_squires}	바스통의 짐승사냥꾼
{brt_alberic_de_bordeleaux}	보르들로의 알베릭
{brt_foot_squires}	보행 종자
{brt_ror_knights_of_the_realm_full}	사자심장 기사 (왕국 기사)
{brt_ror_knights_of_the_realm}	사자심장 기사
{brt_ror_knigts_errant_full}	성 백합의 수호자 (편력 기사)
{brt_ror_knigts_errant}	성 백합의 수호자
{brt_grail_knights}	성배 기사
{brt_grail_guardians}	성배 수호자
{brt_grail_reliquae}	성배 유해
{brt_paladin}	성전사
{brt_questing_knights}	수행 기사
{brt_green_knight}	신록의 기사
{brt_field_trebuchets}	야전 투석기
{brt_damsel_life}	여식 (생명)
{brt_damsel_beasts}	여식 (야수)
{brt_damsel_heavens}	여식 (천상)
{brt_prophetess_life}	예언가 (생명)
{brt_prophetess_beasts}	예언가 (야수)
{brt_prophetess_heavens}	예언가 (천상)
{brt_knights_of_the_realm}	왕국 기사
{brt_royal_pegasus_knights}	왕실 페가서스 기사
{brt_royal_hippogryph_knights}	왕실 히포그리프 기사
{brt_mounted_yeomen_archers}	요먼 기마 궁수
{brt_mounted_yeomen}	요먼 기수
{brt_battle_pilgrims}	전투 순례자
{brt_blessed_field_trebuchets}	축복받은 야전 투석기
{brt_ror_questing_knights_full}	퀘넬 원정대 (수행 기사)
{brt_ror_questing_knights}	퀘넬 원정대
{brt_henri_le_massif}	태산의 앙리
{brt_pegasus_knights}	페가서스 기사
{brt_fey_enchantress}	페이 인챈트리스
{brt_knigts_errant}	편력 기사
{chs_ror_chaos_warriors_full}	거울 근위대 (카오스 전사)
{chs_ror_chaos_warriors}	거울 근위대
{chs_exalted_hero}	고위 영웅
{chs_marauder_horsemen}	기마 약탈단
{chs_marauder_horsemen_throwing_axes}	기마 약탈단 (도끼 투척)
{chs_forsaken}	버림받은 자
{chs_lord_of_change}	변화의 군주
{chs_ror_dragon_ogres_full}	분노의 소환사 (용 오거)
{chs_ror_dragon_ogres}	분노의 소환사
{chs_chosen}	선택받은 자
{chs_chosen_great_weapons}	선택받은 자 (대형 무기)
{chs_chosen_halberds}	선택받은 자 (미늘창)
{chs_ror_forsaken_full}	악의 토사물 (버림받은 자)
{chs_ror_forsaken}	악의 토사물
{chs_gorebeast_chariots}	야수고어 전차
{chs_aspiring_champions}	야심 찬 투사
{chs_archaon_the_everchosen}	영원의 선택받은 자 아카온
{chs_everchosen}	영원의 선택받은 자
{chs_sarthorael_the_everwatcher}	영원한 감시자 사르토라엘
{chs_everwatcher}	영원한 감시자
{chs_sarthorael}	사르토라엘
{chs_dragon_ogres}	용 오거
{chs_dragon_ogre_shaggoth}	용 오거 샤고스
{chs_ror_chaos_spawn_full}	인과의 산물 (혼돈의 산물)
{chs_ror_chaos_spawn}	인과의 산물
{chs_prince_sigvald_the_magnificent}	장엄한 지그발트 대공
{chs_ror_hellcannon_full}	저주받은 영혼 (지옥포)
{chs_ror_hellcannon}	저주받은 영혼
{chs_marauder_horsemasters}	정예 기마 약탈단
{chs_hellcannon}	지옥포
{chs_chaos_giant}	카오스 거인
{chs_chaos_warhounds}	카오스 군견
{chs_chaos_warhounds_poison}	카오스 군견 (독)
{chs_chaos_lord}	카오스 군주
{chs_chaos_knights}	카오스 기사
{chs_chaos_knights_lances}	카오스 기사 (마창)
{chs_chaos_sorcerer_lord}	카오스 마도 군주
{chs_chaos_sorcerer_lord_shadows}	카오스 마도 군주 (그림자)
{chs_chaos_sorcerer_lord_metal}	카오스 마도 군주 (금속)
{chs_chaos_sorcerer_lord_death}	카오스 마도 군주 (죽음)
{chs_chaos_sorcerer_lord_fire}	카오스 마도 군주 (화염)
{chs_chaos_sorcerer}	카오스 마도사
{chs_chaos_sorcerer_shadows}	카오스 마도사 (그림자)
{chs_chaos_sorcerer_metal}	카오스 마도사 (금속)
{chs_chaos_sorcerer_death}	카오스 마도사 (죽음)
{chs_chaos_sorcerer_fire}	카오스 마도사 (화염)
{chs_chaos_feral_manticore}	카오스 야생 만티코어
{chs_chaos_marauders}	카오스 약탈자
{chs_chaos_marauders_great_weapons}	카오스 약탈자 (대형 무기)
{chs_chaos_warriors}	카오스 전사
{chs_chaos_warriors_great_weapons}	카오스 전사 (대형 무기)
{chs_chaos_warriors_halberds}	카오스 전사 (미늘창)
{chs_chaos_chariots}	카오스 전차
{chs_chaos_trolls}	카오스 트롤
{chs_chaos_trolls_armoured}	카오스 트롤 (갑주)
{chs_ror_chaos_knights_full}	카오스의 검 (카오스 기사)
{chs_ror_chaos_knights}	카오스의 검
{chs_kholek_suneater}	콜렉 선이터
{chs_chaos_dragon}	혼돈룡
{chs_chaos_spawn}	혼돈의 산물
{bst_razorgors}	가시고어
{bst_razorgor_herd}	가시고어 무리
{bst_razorgor_chariots}	가시고어 전차
{bst_ror_centigors_great_weapons_full}	고로스의 자식들 (네발고어 - 대형 무기)
{bst_ror_centigors_great_weapons}	고로스의 자식들
{bst_ghorgon}	고르곤
{bst_gor_herd}	고어 무리
{bst_gor_herd_shields}	고어 무리 (방패)
{bst_great_bray_shaman}	고위 포효 주술사
{bst_great_bray_shaman_shadows}	고위 포효 주술사 (그림자)
{bst_great_bray_shaman_wild}	고위 포효 주술사 (야생)
{bst_great_bray_shaman_beasts}	고위 포효 주술사 (야수)
{bst_great_bray_shaman_death}	고위 포효 주술사 (죽음)
{bst_centigors}	네발고어
{bst_centigors_great_weapons}	네발고어 (대형 무기)
{bst_centigors_throwing_axes}	네발고어 (도끼 투척)
{bst_ror_ungor_spearmen_herd_shields_full}	드라크발트의 파괴자 (언고어 창병 무리 - 방패)
{bst_ror_ungor_spearmen_herd_shields}	드라크발트의 파괴자
{bst_ror_cygor_full}	모르슬리프의 눈 (외눈고어)
{bst_ror_cygor}	모르슬리프의 눈
{bst_minotaurs}	미노타우르스
{bst_minotaurs_great_weapons}	미노타우르스 (대형 무기)
{bst_minotaurs_shields}	미노타우르스 (방패)
{bst_morghur_the_shadowgave}	암운의 몰구르
{bst_spawn_of_shadowgave}	암운의 산물
{bst_malagor the dark omen}	암흑의 징조 말라고어
{bst_feral_manticore}	야생 만티코어
{bst_beastlord}	야수 군주
{bst_ungors}	언고어
{bst_ungor_herd}	언고어 무리
{bst_ungor_raiders}	언고어 습격대
{bst_ungor_spearmen_herd}	언고어 창병 무리
{bst_ungor_spearmen_herd_shields}	언고어 창병 무리 (방패)
{bst_tuskgor_chariots}	엄니고어 전차
{bst_cygor}	외눈고어
{bst_khazrak_the_one_eye}	외눈의 카즈라크
{bst_the_salzenmund_soul_eaters}	잘첸문트 영혼 포식자
{bst_jabberslythe}	재버슬리드
{bst_wargor}	전쟁고어
{bst_bestigor}	최상고어
{bst_bestigor_herd}	최상고어 무리
{bst_ror_minotaurs_shields_full}	칼켄가르드의 도살자 (미노타우르스 - 방패)
{bst_ror_minotaurs_shields}	칼켄가르드의 도살자
{bst_ror_bestigor_herd_full}	코로크의 인간도살자들 (최상고어 무리)
{bst_ror_bestigor_herd}	코로크의 인간도살자들
{bst_ghorgon_of_khorne}	코른의 고르곤
{bst_doombull}	파멸의 황소
{bst_ror_jabberslythe_full}	포르베르글란트의 무리어미 (재버슬리드)
{bst_ror_jabberslythe}	포르베르글란트의 무리어미
{bst_bray_shaman}	포효 주술사
{bst_bray_shaman_shadows}	포효 주술사 (그림자)
{bst_bray_shaman_wild}	포효 주술사 (야생)
{bst_bray_shaman_beasts}	포효 주술사 (야수)
{bst_bray_shaman_death}	포효 주술사 (죽음)
{bst_ror_ghorgon_full}	핏빛 야성의 거수 (고르곤)
{bst_ror_ghorgon}	핏빛 야성의 거수
{bst_harpies}	하피
{bst_taurox_the_brass_bull}	황동소 타우록스
{bst_gorebull}	황소고어
{bst_ror_centigors_throwing_axes_full}	황야를 달리는 잡종발굽 (네발고어 - 도끼 투척)
{bst_ror_centigors_throwing_axes}	황야를 달리는 잡종발굽
{wef_sisters_of_the_thorn}	가시의 자매단
{wef_giant_spiders}	거대 거미
{wef_great_hawks}	거대 매
{wef_great_stag_knights}	거대 수사슴 기사
{wef_giant_wolves}	거대한 늑대
{wef_bladesingers}	검의 가수
{wef_ror_eternal_guard_shields_full}	겨울심장 근위대 (영원 근위대 - 방패)
{wef_ror_eternal_guard_shields}	겨울심장 근위대
{wef_ror_zoats_full}	기란의 수수께끼 (조트)
{wef_ror_zoats}	기란의 수수께끼
{wef_ror_great_stag_knights_full}	길 잃은 실반 기사단 (거대 수사슴 기사)
{wef_ror_great_stag_knights}	길 잃은 실반 기사단
{wef_deepwood_scouts}	깊은 숲 정찰병
{wef_deepwood_scouts_swiftshiver_shards}	깊은 숲 정찰병 (신속의 파편)
{wef_ancient_treeman}	나무 장로
{wef_tree_kin}	나무 정령
{wef_treeman}	나무사람
{wef_branchwraith}	나뭇가지 망령
{wef_cave_bats}	동굴 박쥐
{wef_durthu}	두르투
{wef_dryads}	드라이어드
{wef_drycha}	드라이차
{wef_ror_waywatchers_full}	드라키라의 매의 눈 (수호의 감시대)
{wef_ror_waywatchers}	드라키라의 매의 눈
{wef_ror_wardancers_asrai_spears_full}	로엑의 장난꾼 (전쟁의 무희 - 아스라이 창)
{wef_ror_wardancers_asrai_spears}	로엑의 장난꾼
{wef_spellweaver}	마법의 직공
{wef_spellweaver_high}	마법의 직공 (고위)
{wef_spellweaver_shadows}	마법의 직공 (그림자)
{wef_spellweaver_life}	마법의 직공 (생명)
{wef_spellweaver_beasts}	마법의 직공 (야수)
{wef_spellweaver_dark}	마법의 직공 (어둠)
{wef_hawk_riders}	매 기수
{wef_ror_tree_kin_full}	불꽃껍질 장로 (나무 정령)
{wef_ror_tree_kin}	불꽃껍질 장로
{wef_glade_lord}	삼림 군주
{wef_glade_guard}	삼림 근위대
{wef_glade_guard_hagbane_tips}	삼림 근위대 (마녀독 화살촉)
{wef_glade_guard_starfire_shafts}	삼림 근위대 (별불꽃 화살대)
{wef_glade_riders}	삼림 기병대
{wef_glade_riders_hagbane_tips}	삼림 기병대 (마녀독 화살촉)
{wef_glade_riders_spears}	삼림 기병대 (창)
{wef_glade_captain}	삼림대장
{wef_forest_dragon}	삼림용
{wef_radixashen_full}	세계의 뿌리의 독사 라딕사셴
{wef_waywatchers}	수호의 감시대
{wef_waystalker}	수호의 추적자
{wef_ror_wildwood_rangers_full}	시스랄의 감시자 (야생숲 순찰자)
{wef_ror_wildwood_rangers}	시스랄의 감시자
{wef_ariel}	아리엘
{wef_malevolent_tree_kin}	악랄한 나무 정령
{wef_malevolent_branchwraith}	악심 품은 나뭇가지 망령
{wef_malevolent_branchwraith_shadows}	악심 품은 나뭇가지 망령 (그림자)
{wef_malevolent_branchwraith_life}	악심 품은 나뭇가지 망령 (생명)
{wef_malevolent_branchwraith_beasts}	악심 품은 나뭇가지 망령 (야수)
{wef_malevolent_ancient_treeman_shadows}	앙심 품은 나무 장로 (그림자)
{wef_malevolent_ancient_treeman_life}	앙심 품은 나무 장로 (생명)
{wef_malevolent_ancient_treeman_beasts}	앙심 품은 나무 장로 (야수)
{wef_malevolent_treeman}	앙심 품은 나무사람
{wef_malevolent_dryads}	앙심 품은 드라이어드
{wef_wild_riders}	야생 기병대
{wef_wild_riders_shields}	야생 기병대 (방패)
{wef_wildwood_rangers}	야생숲 순찰자
{wef_ror_dryads_full}	얼어붙은 심장의 망령 (드라이어드)
{wef_ror_dryads}	얼어붙은 심장의 망령
{wef_eternal_guard}	영원 근위대
{wef_eternal_guard_shields}	영원 근위대 (방패)
{wef_orion}	오리온
{wef_wardancers}	전쟁의 무희
{wef_wardancers_asrai_spears}	전쟁의 무희 (아스라이 창)
{wef_zoats}	조트
{wef_spellsinger}	주문노래꾼
{wef_spellsinger_shadows}	주문노래꾼 (그림자)
{wef_spellsinger_life}	주문노래꾼 (생명)
{wef_spellsinger_beasts}	주문노래꾼 (야수)
{wef_coeddil}	코에딜
{wef_ror_wild_riders_shields_full}	쿠르노스의 야생 사냥꾼 (야생 기병대 - 방패)
{wef_ror_wild_riders_shields}	쿠르노스의 야생 사냥꾼
{wef_great_eagle}	큰독수리
{wef_sisters_of_twilight}	황혼의 자매
{wef_arahan}	아레이한
{wef_naestra}	나에스트라
{nor_kihar_the_tormentor}	고문관 키하르
{nor_norscan_giant}	노스카 거인
{nor_norscan_warhounds}	노스카 군견
{nor_norscan_warhounds_poison}	노스카 군견 (독)
{nor_norscan_ice_wolves}	노스카 얼음 늑대
{nor_norscan_ice_trolls}	노스카 얼음 트롤
{nor_norscan_trolls}	노스카 트롤
{nor_skin wolves}	늑대두겁
{nor_skin wolves_armoured}	늑대두겁 (장갑 무장)
{nor_shaman_sorcerer}	마도 주술사
{nor_shaman_sorcerer_metal}	마도 주술사 (금속)
{nor_shaman_sorcerer_death}	마도 주술사 (죽음)
{nor_shaman_sorcerer_fire}	마도 주술사 (화염)
{nor_azrik_the_maze_keeper}	미궁 감시자 아즈릭
{nor_wulfrik_the_wanderer}	방랑자 울프릭
{nor_mother_of_the_flame}	불의 어머니
{nor_ror_marauder_berserkers_full}	사냥개 신의 짐승들 (약탈자 광전사)
{nor_ror_marauder_berserkers}	사냥개 신의 짐승들
{nor_frost_wyrm}	서리 괴룡
{nor_ror_fimir_warriors_full}	안개 속 추적자 (피미르 전사)
{nor_ror_fimir_warriors}	안개 속 추적자
{nor_ror_skin wolves_armoured_full}	야만의 주둥이 (늑대두겁 - 갑옷 무장)
{nor_ror_skin wolves_armoured}	야만의 주둥이
{nor_feral_mammoth}	야생 맘모스
{nor_skin_wolf_werekin}	야성의 늑대두겁
{nor_marauders}	약탈자
{nor_marauders_great_weapons}	약탈자 (대형 무기)
{nor_marauder_berserkers}	약탈자 광전사
{nor_marauder_hunters}	약탈자 사냥꾼
{nor_marauder_hunters_javelins}	약탈자 사냥꾼 (투창)
{nor_marauder_ice_wolves_chariots}	약탈자 얼음 늑대 전차
{nor_marauder_chariots}	약탈자 전차
{nor_chieftain}	족장
{nor_marauder_chieftain}	약탈자 족장
{nor_marauder_spearmen}	약탈자 창병
{nor_marauder_champions}	약탈자 투사
{nor_marauder_champions_great_weapons}	약탈자 투사 (대형 무기)
{nor_the_ice_forged_legion}	얼음 벼림 군단
{nor_ror_marauders_full}	얼음뿔 약탈꾼 (약탈자)
{nor_ror_marauders}	얼음뿔 약탈꾼
{nor_ror_war_mammoth_full}	영혼을 짓밟는 발 (전쟁 맘모스)
{nor_ror_war_mammoth}	영혼을 짓밟는 발
{fimir_balefiend}	재앙의 마귀 피미르
{fimir_balefiend_shadows}	재앙의 마귀 피미르 (그림자)
{fimir_balefiend_fire}	재앙의 마귀 피미르 (화염)
{nor_war_mammoth}	전쟁 맘모스
{nor_war_mammoth_warshrine}	전쟁 맘모스 (전쟁 제단)
{nor_frigustrex_full}	차가운 공허의 후예 프리구스트렉스
{nor_ror_frost_wyrm_full}	차가운 공허자 (서리 괴룡)
{nor_ror_frost_wyrm}	차가운 공허자
{nor_ror_norscan_warhounds_full}	타쉬나르의 야수 (노스카 군견)
{nor_ror_norscan_warhounds}	타쉬나르의 야수
{nor_throgg}	트로그
{nor_fimir}	피미르
{nor_fimir_warriors}	피미르 전사
{nor_fimir_warriors_great_weapons}	피미르 전사 (대형 무기)
{nor_ror_the_great_mawherd_of_bloodfjord_full}	핏빛 피요르드의 아가리떼 (야생 맘모스)
{nor_ror_the_great_mawherd_of_bloodfjord}	핏빛 피요르드의 아가리떼
[hef_gate_guard}	관문 경비병
{hef_alarielle_the_radiant}	광명의 알라리엘
{hef_archers_light_armour}	궁병 (경갑)
{hef_noble}	귀족
{hef_shadow_walkers}	그늘을 걷는 자
{hef_hand_of_the_shadow_crown}	그림자 왕관의 손
{hef_shadow_warriors}	그림자 전사
{hef_prince}	대공
{hef_archmage}	대마법사
{hef_archmage_high}	대마법사 (고위)
{hef_archmage_shadows}	대마법사 (그림자)
{hef_archmage_metal}	대마법사 (금속)
{hef_archmage_light}	대마법사 (빛)
{hef_archmage_life}	대마법사 (생명)
{hef_archmage_beasts}	대마법사 (야수)
{hef_archmage_death}	대마법사 (죽음)
{hef_archmage_heavens}	대마법사 (천상)
{hef_archmage_fire}	대마법사 (화염)
{hef_eagle_claw_bolt_throwers}	독수리발톱 노포
{hef_ror_war_lions_of_chrace_full}	라하그라의 사자떼 (크레이스의 전쟁 사자)
{hef_ror_war_lions_of_chrace}	라하그라의 사자떼
{hef_lothern_sea_guard}	로세른 해안 경비대
{hef_lothern_sea_guard_shields}	로세른 해안 경비대 (방패)
{hef_mage}	마법사
{hef_mage_high}	마법사 (고위)
{hef_mage_shadows}	마법사 (그림자)
{hef_mage_metal}	마법사 (금속)
{hef_mage_light}	마법사 (빛)
{hef_mage_life}	마법사 (생명)
{hef_mage_beasts}	마법사 (야수)
{hef_mage_death}	마법사 (죽음)
{hef_mage_heavens}	마법사 (천상)
{hef_mage_fire}	마법사 (화염)
{hef_ror_spearmen_full}	마슬란의 자손들 (창병)
{hef_ror_spearmen}	마슬란의 자손들
{hef_ror_ellyrian_reaver_archers_full}	바람의 사자 (엘리리아 기마 궁수대)
{hef_ror_ellyrian_reaver_archers}	바람의 사자 (엘리리아 기마 궁수대)
{hef_white_lion}	백사자
{hef_alastar_the_white_lion}	백사자 알라스타
{hef_phoenix_guard}	불사조 근위대
{hef_arcane_phoenix}	비전 불사조
{hef_bruwor_full}	생명의 수호자 브루오르
{hef_frostheart_phoenix}	서리심장 불사조
{hef_ror_white_lions_of_chrace_full}	순혈갈기 중대 (크레이스의 백사자)
{hef_ror_white_lions_of_chrace}	순혈갈기 중대
{hef_sisters_of_avelorn}	아벨로른의 자매단
{hef_ror_arcane_phoenix_full}	아수리얀의 징조 (비전 불사조)
{hef_ror_arcane_phoenix}	아수리얀의 징조
{hef_sentinels_of_astaril}	아스타릴의 파수꾼
{hef_athel_tamarha_faithbearers}	아텔 타마르하 신념대
{hef_alith_anar}	알리스 아나르
{hef_lamoureux_full}	얼어붙는 입김의 라모로
{hef_ellyrian_reaver_archers}	엘리리아 기마 궁수대
{hef_ellyrian_reavers}	엘리리아 기마대
{hef_princess}	여대공
{hef_ror_sisters_of_avelorn_full}	영원여왕의 궁정 수비단 (아벨로른의 자매단)
{hef_ror_sisters_of_avelorn}	영원여왕의 궁정 수비단
{hef_handmaiden_of_the_everqueen}	영원여왕의 시녀
{hef_ymwrath_full}	영원의 임라스
{hef_dragon_princes}	용공 기병대
{hef_dragon_princes_short}	용공
{hef_silverin_guard}	은빛 근위대
{hef_silver_helms}	은빛 투구대
{hef_silver_helms_shields}	은빛 투구대 (방패)
{hef_moon_dragon}	은월룡
{hef_ithilmar_chariots}	이실마르 전차
{hef_imrik}	임릭
{hef_shackolot_full}	재앙의 샤콜롯
{hef_ror_shadow_warriors_full}	잿빛단 (그림자 전사)
{hef_ror_shadow_warriors}	잿빛단
{hef_star_dragon}	천체룡
{hef_lion_chariots_of_chrace}	크레이스 사자 전차
{hef_white_lions_of_chrace}	크레이스의 백사자
{hef_war_lions_of_chrace}	크레이스의 전쟁 사자
{hef_sun_dragon}	태양룡
{hef_teclis}	테클리스
{hef_knights_of_tor_gaval}	토르 가벌 기사단
{hef_spire_guard_of_tor_yvresse}	토르 이브레스의 첨탑 경비대
{hef_ror_archers_light_armour_full}	토르 칼레다의 갈고리 (궁병 - 경갑)
{hef_ror_archers_light_armour}	토르 칼레다의 갈고리
{hef_tiranoc_chariots}	티라녹 전차
{hef_tyrion}	티리온
{hef_ror_lothern_sea_guard_full}	폭풍의 기수 (로세른 해안 경비대)
{hef_ror_lothern_sea_guard}	폭풍의 기수
{hef_the_skyhawks}	하늘매
{hef_eltharion_the_grim}	한 품은 엘타리온
{hef_swordmasters_of_hoeth}	호에스의 검성
{hef_swordmasters}	검성
{hef_loremaster_of_hoeth}	호에스의 대마법학자
{hef_loremaster}	대마법학자
{hef_flamespyre_phoenix}	화염봉우리 불사조
{hef_gordinar_full}	화염의 대전사 고르디나르
{hef_ror_phoenix_guard_full}	화염의 수호자 (불사조 근위대)
{hef_ror_phoenix_guard}	화염의 수호자
{hef_ror_dragon_princes_full}	화염의 자손 (용공 기병대)
{hef_ror_dragon_princes}	화염의 자손
{hef_everqueen}	영원여왕
{def_black_ark_corsairs}	검은 방주 해적
{def_black_ark_corsairs_handbows}	검은 방주 해적 (손쇠뇌)
{def_beastmaster}	야수 조련사
{def_high_beastmaster}	고위 야수 조련사
{def_supreme_sorceress}	고위 여마도사
{def_supreme_sorceress_shadows}	고위 여마도사 (그림자)
{def_supreme_sorceress_beasts}	고위 여마도사 (야수)
{def_supreme_sorceress_dark}	고위 여마도사 (어둠)
{def_supreme_sorceress_death}	고위 여마도사 (죽음)
{def_supreme_sorceress_fire}	고위 여마도사 (화염)
{def_ror_repeater_crossbow_full}	까마귀의 사자 (연발 쇠뇌)
{def_ror_repeater_crossbow}	까마귀의 사자
{def_black_guard_of_naggarond}	나가론드의 검은 근위대
{def_black_guard}	검은 근위대
{def_crone_hellebron}	노파 헬레브론
{def_the_beast_of_raema}	라에마의 짐승
{def_rakarth}	라카스
{def_ror_scourgerunner_chariots_full}	라카스의 약탈자 (재앙몰이 전차)
{def_ror_scourgerunner_chariots}	라카스의 약탈자 (재앙몰이 전차)
{def_lokhir_fellheart}	로키어 펠하트
{def_witch_elves}	마녀 엘프
{def_witch_king}	마술사왕
{def_malekith}	말레키스
{def_malus_darkblade}	말루스 다크블레이드
{def_tzarkan}	차르칸
{def_morathi}	모라티
{def_ror_bloodwrack_medusa_full}	붉은 폐허의 사이렌 (피에 찌든 메두사)
{def_ror_bloodwrack_medusa}	붉은 폐허의 사이렌
{def_reaper_bolt_throwers}	사신 노포
{def_ror_war_hydra_full}	손타의 냉기 (전쟁 히드라)
{def_ror_war_hydra}	손타의 냉기
{def_ror_doomfire_warlocks_full}	슬라네쉬의 수확자들 (파멸의 화염 워록)
{def_ror_doomfire_warlocks}	슬라네쉬의 수확자들
{def_shades}	암영단
{def_shades_greatswords}	암영단 (대검)
{def_shades_dual_weapons}	암영단 (쌍수 무기)
{def_dark_riders}	암흑 기수
{def_dark_riders_shields}	암흑 기수 (방패)
{def_dark_riders_repeater_crossbow}	암흑 기수 (연발 쇠뇌)
{def_black_dragon}	암흑룡
{def_dark_hold}	어둠의 아성
{def_sorceress}	여마도사
{def_sorceress_shadows}	여마도사 (그림자)
{def_sorceress_beasts}	여마도사 (야수)
{def_sorceress_dark}	여마도사 (어둠)
{def_sorceress_death}	여마도사 (죽음)
{def_sorceress_fire}	여마도사 (화염)
{def_scourgerunner_chariots}	재앙몰이 전차
{def_dreadlord}	전율의 군주
{def_dreadlord_sword_and_shield}	전율의 군주 (검과 방패)
{def_dreadlord_sword_and_crossbow}	전율의 군주 (검과 쇠뇌)
{def_dreadspears}	전율의 창
{def_war_hydra}	전쟁 히드라
{def_bleakswords}	절망의 검
{def_death_hag}	죽음의 노파
{def_darkshards}	칠흑의 화살
{def_darkshards_shields}	칠흑의 화살 (방패)
{def_kharibdyss}	카리브디스
{def_khainite_assassin}	케인 교단 암살자
{def_ror_harpies_full}	케인의 까마귀떼 (하피)
{def_ror_harpies}	케인의 까마귀떼
{def_cold_one_knights}	콜드 원 기사
{def_cold_one_dread_knights}	콜드 원 전율의 기사
{def_cold_one_chariots}	콜드 원 전차
{def_master}	통달자
{def_ror_witch_elves_full}	파멸을 노래하는 자매단 (마녀 엘프)
{def_ror_witch_elves}	파멸을 노래하는 자매단
{def_doomfire_warlocks}	파멸의 화염 워록
{def_explosive_squig}	폭발 스퀴그
{def_bloodwrack_medusa}	피에 찌든 메두사
{def_bloodwrack_shrine}	피에 찌든 성소
{def_ror_har_ganeth_executioners_full}	피의 여왕의 칼날 (처형자)
{def_ror_har_ganeth_executioners}	피의 여왕의 칼날
{def_har_ganeth_executioners}	하르 가네스 처형자
{def_sisters_of_slaughter}	학살의 자매단
{def_ror_dreadspears_full}	헬레브론의 수하 (전율의 창)
{def_ror_dreadspears}	헬레브론의 수하
{def_ror_darkshards_shields_full}	화살마 (칠흑의 화살 - 방패)
{def_ror_darkshards_shields}	화살마
{def_ror_dread_knights_full}	흑단 발톱 기사단 (전율의 기사단)
{lzd_gargantulzan}	가르간툴잔
{lzd_ror_feral_carnosaur_full}	겔트블롬의 공포 (야생 카르노사우루스)
{lzd_ror_feral_carnosaur}	겔트블롬의 공포
{lzd_ancient_salamander}	고대 샐러맨더
{lzd_ancient_stegadon}	고대 스테가돈
{lzd_ancient_stegadon_engine_of_the_gods}	고대 스테가돈 (신들의 기계)
{lzd_kroxigor_ancient}	고대의 크록시거
{lzd_gor_rok}	고르-록
{lzd_lord_mazdamundi}	군주 마즈다문디
{lzd_lord_kroak}	군주 크로악
{lzd_ror_salamander_hunting_pack_full}	그늘진 조류 (샐러맨더 사냥 무리)
{lzd_dread_saurian}	드레드 사우리안
{lzd_ror_dread_saurian_full}	러스트리아의 분쇄자 (드레드 사우리안)
{lzd_ror_dread_saurian}	러스트리아의 분쇄자
{lzd_razordon_hunting_pack}	레이저돈 사냥 무리
{lzd_ripperdactyl}	리퍼닥틸
{lzd_ripperdactyl_riders}	리퍼닥틸 기수
{lzd_bastiladon}	바스틸라돈
{lzd_bastiladon_ark_of_sotek}	바스틸라돈 (소텍의 방주)
{lzd_bastiladon_revivification_crystal}	바스틸라돈 (원기회복의 수정)
{lzd_bastiladon_solar_engine}	바스틸라돈 (태양 제단)
{lzd_nakai_the_wanderer}	방랑자 나카이
{lzd_ror_temple_guard_full}	별의 방 수호대 (신전 수호대)
{lzd_ror_temple_guard}	별의 방 수호대
{lzd_red_crested_skink}	붉은 볏 스킹크
{lzd_red_crested_skink_chief}	붉은 볏 스킹크 족장
{lzd_saurus_scar_veteran}	사우루스 스카-베테랑
{lzd_scar_veteran}	스카 베테랑
{lzd_saurus_oldblood}	사우루스 올드블러드
{lzd_saurus_warriors}	사우루스 전사
{lzd_saurus_warriors_shields}	사우루스 전사 (방패)
{lzd_saurus_spears}	사우루스 창병
{lzd_saurus_spears_shields}	사우루스 창병 (방패)
{lzd_salamander}	샐러맨더 사냥 무리
{lzd_salamander_hunting_pack}	샐러맨더 사냥 무리
{lzd_ror_red_crested_skinks_full}	소텍의 집단 (붉은 볏 스킹크)
{lzd_ror_red_crested_skinks}	소텍의 집단
{lzd_skink_priest}	스킹크 사제
{lzd_skink_priest_beasts}	스킹크 사제 (야수)
{lzd_skink_priest_heavens}	스킹크 사제 (천상)
{lzd_skink_priest_avatar}	스킹크 사제 화신
{lzd_skink_skirmishers}	스킹크 산병
{lzd_skink_oracle}	스킹크 예언자
{lzd_skink_chief}	스킹크 족장
{lzd_skink_cohort}	스킹크 집단
{lzd_skink_cohort_javelins}	스킹크 집단 (투창)
{lzd_stegadon}	스테가돈
{lzd_mage_priest}	법사 사제
{lzd_slann_mage_priest}	슬란 법사 사제
{lzd_slann_mage_priest_high}	슬란 법사 사제 (고위)
{lzd_slann_mage_priest_light}	슬란 법사 사제 (빛)
{lzd_slann_mage_priest_life}	슬란 법사 사제 (생명)
{lzd_slann_mage_priest_heavens}	슬란 법사 사제 (천상)
{lzd_slann_mage_priest_fire}	슬란 법사 사제 (화염)
{lzd_sacred_kroxigor}	신성한 크록시거
{lzd_temple_guards}	신전 수호대
{lzd_ror_razordon_hunting_pack_full}	아막손 가시덩쿨 (레이저돈 사냥 무리)
{lzd_ror_razordon_hunting_pack}	아막손 가시덩쿨
{lzd_feral_bastiladon}	야생 바스틸라돈
{lzd_feral_stegadon}	야생 스테가돈
{lzd_carnosaur}	카르노사우루스
{lzd_feral_carnosaur}	야생 카르노사우루스
{lzd_feral_cold_ones}	야생 콜드 원
{lzd_feral_troglodon}	야생 트로글로돈
{lzd_feral_dread_saurian}	야생의 드레드 사우리안
{lzd_oxyotl}	옥시오틀
{lzd_ror_ancient_stegadon_full}	우렁찬 놈 (고대 스테가돈)
{lzd_ror_ancient_stegadon}	우렁찬 놈
{lzd_ror_saurus_spears_full}	차쿠아의 군단 (사우루스 창병)
{lzd_ror_saurus_spears}	차쿠아의 군단
{lzd_ror_feral_troglodon_full}	창백한 죽음 (야생 트로글로돈)
{lzd_ror_feral_troglodon}	창백한 죽음
{lzd_blessed_bastiladon_solar_engine}	축복받은 바스틸라돈 (태양 제단)
{lzd_blessed_saurus_warriors_shields}	축복받은 사우루스 전사 (방패)
{lzd_blessed_saurus_spears_shields}	축복받은 사우루스 창병 (방패)
{lzd_blessed_skink_skirmishers}	축복받은 스킹크 산병
{lzd_blessed_stegadon}	축복받은 스테가돈
{lzd_blessed_temple_guards}	축복받은 신전 수호대
{lzd_blessed_carnosaur}	축복받은 카르노사우루스
{lzd_blessed_chameleon_skinks}	축복받은 카멜레온 스킹크
{lzd_blessed_cold_one_spear_riders}	축복받은 콜드 원 기수 창병
{lzd_blessed_kroxigor}	축복받은 크록시거
{lzd_blessed_terradon_riders_fireleech_bolas}	축복받은 테라돈 기수 (불거머리 올가미)
{lzd_blessed_horned_ones}	축복받은 혼드 원
{lzd_chameleon_skinks}	카멜레온 스킹크
{lzd_chameleon_stalkers}	카멜레온 추적자
{lzd_coatl}	코아틀
{lzd_cold_one_riders}	콜드 원 기수
{lzd_cold_one_spear_riders}	콜드 원 기수 창병
{lzd_ror_ripperdactyl_riders_full}	콜로사돈 사냥꾼 (리퍼닥틸 기수)
{lzd_ror_ripperdactyl_riders}	콜로사돈 사냥꾼
{lzd_kroq_gar}	크록-가르
{lzd_kroxigor}	크록시거
{lzd_terradon}	테라돈
{lzd_terradon_riders}	테라돈 기수
{lzd_terradon_riders_fireleech_bolas}	테라돈 기수 (불거머리 올가미)
{lzd_ror_coatl_full}	테폭의 혼령 (코아틀)
{lzd_ror_coatl}	테폭의 혼령
{lzd_tehenhauin}	테헨하우인
{lzd_tiktaqto}	틱타크'토
{lzd_ror_terradon_riders_full}	파후악스의 파수꾼 (테라돈 기수)
{lzd_ror_terradon_riders}	파후악스의 파수꾼
{lzd_ror_cold_one_spear_riders_full}	폭-호팍 집단 (콜드 원 기수 창병)
{lzd_ror_cold_one_spear_riders}	폭-호팍 집단
{lzd_horned_ones}	혼드 원
{lzd_ror_sacred_kroxigor_full}	후아틀의 집단 (신성한 크록시거)
{lzd_ror_sacred_kroxigor}	후아틀의 집단
{skv_ror_doom_flayers_black_full}	검은구멍 박피기 (파멸의 박피기)
{skv_ghoritch}	고리치
{skv_ror_hell_pit_abomination_full}	괴물-놈 (헬 핏 혐오체)
{skv_ror_hell_pit_abomination}	괴물-놈
{skv_ror_doomwheel_full} 	굴러다니는 파멸 (파멸의 쳇바퀴)
{skv_ror_doomwheel} 	굴러다니는 파멸
{skv_ror_warplock_jezails_natty_full}	내티 부보의 명사수 (워프락 제자일)
{skv_ror_warplock_jezails_natty}	내티 부보의 명사수
{skv_ror_poisoned_wind_mortars_full}	눈사태 폭격대 (독 바람 박격포)
{skv_ror_poisoned_wind_mortars}	눈사태 폭격대
{skv_ror_warplock_jezails_eye_full}	눈알 사냥꾼 (워프락 제자일)
{skv_wolf_rats}	늑대 쥐
{skv_wolf_rats_poison}	늑대 쥐 (독)
{skv_poisoned_wind_mortars}	독 바람 박격포
{skv_poisoned_wind_globadiers}	독 바람 척탄병
{skv_mutant_rat_ogre}	돌연변이 쥐 오거
{skv_ror_doom_flayers_dwarf_full}	드워프-놈 위협기 (파멸의 박피기)
{skv_ror_doom_flayers_dwarf}	드워프-놈 위협기
{skv_brood_horror}	떼거리의 정점
{skv_ratling_guns}	래틀링 건
{skv_ror_mutant_rat_ogre_full}	모르스키터의 쥐망나니 (돌연변이 쥐 오거)
{skv_ror_mutant_rat_ogre}	모르스키터의 쥐망나니
{skv_packmaster}	무리 관리자
{skv_ror_clanrats_shields_full}	벌큰 클랜의 꼬리가름꾼 (클랜 쥐 - 방패)
{skv_ror_clanrats_shields}	벌큰 클랜의 꼬리가름꾼
{skv_throt_the_unclean}	불결한 스롯
{skv_ror_plague_monk_censer_bearers_full}	블라이트스캡의 역병무리 (향로 무장 역병승려)
{skv_ror_plague_monk_censer_bearers}	블라이트스캡의 역병무리
{skv_ror_death_runners_full}	비스크트린 사신 부대 (죽음의 주자)
{skv_ror_death_runners}	비스크트린 사신 부대
{skv_skavenslaves}	스케이븐 노예
{skv_skavenslave_spears}	스케이븐 노예 창병
{skv_skavenslave_slingers}	스케이븐 노예 투석병
{skv_lord_skrolk}	스크롤크 군주
{skv_the_hellbeast_of_seep_gore}	시프-고어의 지옥 야수
{skv_night_runners}	심야의 주자
{skv_night_runners_slings}	심야의 주자 (투석)
{skv_master_assassin}	암살의 달인
{skv_assassin}	암살자
{skv_eshin_sorcerer}	에신 마도사
{skv_eshin_triads}	에신 삼합회
{skv_plagueclaw_catapults}	역병갈퀴 투척기
{skv_plague_priest}	역병사제
{skv_plague_monks}	역병승려
{skv_warlock_engineer}	워록 공학자
{skv_warlock_master}	워록 마스터
{skv_warp_grinders}	워프 굴착꾼
{skv_warp_lightning_cannons}	워프 벼락 포대
{skv_warplock_jezails}	워프락 제자일
{skv_ror_doomwheel_warpfire_full}	워프불꽃 바퀴 (파멸의 쳇바퀴)
{skv_ror_doomwheel}	워프불꽃 바퀴
{skv_warpfire_throwers}	워프화염 방사기
{skv_ror_stormvermin_halberds_full}	의회 근위대 (해악의 폭풍 - 미늘창)
{skv_ror_stormvermin_halberds}	의회 근위대
{skv_ror_ratling_guns_teeth_full}	이빨 분쇄자 (래틀링 건)
{skv_ror_rat_ogres_full}	이빨 분쇄자
{skv_ikit_claw}	이킷 클로
{skv_ror_warp_lightning_cannons_full}	이킷의 찌릿-찌릿! (워프 벼락 포대)
{skv_ror_warp_lightning_cannons}	이킷의 찌릿-찌릿!
{skv_ror_eshin_triads_full}	익샤 삼합회 (에신 삼합회)
{skv_ror_eshin_triads}	익샤 삼합회
{skv_grey_seer}	잿빛 예언자
{skv_grey_seer_plague}	잿빛 예언자 (역병)
{skv_grey_seer_ruin}	잿빛 예언자 (파멸)
{skv_warlord}	전쟁군주
{skv_death_globe_bombardiers}	죽음 구슬 척탄병
{skv_deathmaster_snikch}	죽음의 달인 스닉치
{skv_ror_ratling_guns_death_full}	죽음의 상인 (래틀링 건)
{skv_death_runners}	죽음의 주자
{skv_rat_ogres}	쥐 오거
{skv_ror_rat_ogres_full}	지옥 심연의 투기장 싸움꾼 (쥐 오거)
{skv_ror_rat_ogres}	지옥 심연의 투기장 싸움꾼
{skv_queek_headtaker}	퀵 헤드테이커
{skv_clanrats}	클랜 쥐
{skv_clanrats_shields}	클랜 쥐 (방패)
{skv_clanrat_spears}	클랜 쥐 창병
{skv_clanrat_spears_shields}	클랜 쥐 창병 (방패)
{skv_tretch_craventail}	트레치 크레이븐테일
{skv_doom_flayers}	파멸의 박피기
{skv_ror_warpfire_throwers_full}	파멸의 인도자 (워프화염 방사기)
{skv_doomwheel}	파멸의 쳇바퀴
{skv_gutter_runners}	하수도 주자
{skv_gutter_runners_poison}	하수도 주자 (독)
{skv_gutter_runner_slingers}	하수도 주자 투석병
{skv_gutter_runner_slingers_poison}	하수도 주자 투석병 (독)
{skv_stormvermin}	해악의 폭풍
{skv_stormvermin_sword_and_shield}	해악의 폭풍 (검과 방패)
{skv_stormvermin_halberds}	해악의 폭풍 (미늘창)
{skv_plague_monk_censer_bearers}	향로 무장 역병승려
{skv_hell_pit_abomination}	헬 핏 혐오체
{tmb_arkhan_the_black}	검은 아칸
{tmb_high_queen_khalida}	고위 여왕 칼리다
{vmp_ror_skeleton_spearmen_full}	네케쉬 왕의 전갈 군단 (해골 창병)
{vmp_ror_skeleton_spearmen}	네케쉬 왕의 전갈 군단
{tmb_nehekhara_horsemen}	네헤카라 기수
{tmb_nehekhara_warriors}	네헤카라 워리어
{tmb_grand_hierophant_khatep}	대사제장 카텝
{tmb_ror_the_flock_of_djaf_full}	드자프의 무리 (시체 포식조)
{tmb_liche_priest}	리치 사제
{tmb_liche_priest_shadows}	리치 사제 (그림자)
{tmb_liche_priest_nehekara}	리치 사제 (네헤카라)
{tmb_liche_priest_light}	리치 사제 (빛)
{tmb_liche_priest_death}	리치 사제 (죽음)
{tmb_settra_the_imperishable}	불멸의 세트라
{tmb_necrotect}	불사공학자
{tmb_necropolis_knights}	불사왕국 기사단
{tmb_necropolis_knights_halberds}	불사왕국 기사단 (미늘창)
{tmb_necrosphinx}	불사의 스핑크스
{tmb_bone_giant}	뼈 거인
{tmb_ror_sepulchral_stalkers_full}	사막의 눈 (음침한 추적자)
{tmb_ror_sepulchral_stalkers}	사막의 눈
{tmb_carrion}	시체 포식조
{tmb_hierotitan}	신성 거신
{tmb_ror_ushabti_great_bow_full}	신의 선택을 받은 자 (우샤브티 - 대형 활)
{tmb_ror_ushabti_great_bow}	신의 선택을 받은 자
{tmb_ror_necropolis_knights_full}	아사프의 맹독 기사단 (불사왕국 기사단)
{tmb_casket_of_souls}	영혼의 함
{tmb_tomb_guard}	왕릉 근위대
{tmb_tomb_guard_halberds}	왕릉 근위대 (미늘창)
{tmb_tomb_prince}	왕릉 대공
{tmb_tomb_scorpion}	왕릉 전갈
{tmb_tomb_king}	왕릉왕
{tmb_ushabti}	우샤브티
{tmb_ushabti_great_bow}	우샤브티 (대형 활)
{tmb_ror_necrosphinx_full}	우섹프의 스핑크스 (불사의 스핑크스)
{tmb_ror_necrosphinx}	우섹프의 스핑크스
{tmb_ror_nehekara_warriors_full}	우시리안의 명계 군단 (네헤카라 워리어)
{tmb_sepulchral_stalkers}	음침한 추적자
{tmb_screaming_skull_catapults}	절규하는 해골 투석기
{tmb_ror_tomb_guard_full}	케프라 근위대 (왕릉 근위대)
{tmb_ror_tomb_guard}	케프라 근위대
{tmb_khemrian_warsphinx}	켐리의 전쟁 스핑크스
{tmb_warsphinx}	전쟁 스핑크스
{tmb_ror_nehekhara_horsemen_full}	크사르의 폭풍의 기수 (네헤카라 기수)
{tmb_ror_skeleton_archers_full}	파크스의 축복받은 군단 (해골 궁병)
{tmb_skeleton_archers}	해골 궁병
{tmb_skeleton_archer_chariots}	해골 궁병 전차
{tmb_skeleton_horsemen}	해골 기수
{tmb_skeleton_horse_archers}	해골 기수 궁병
{tmb_skeleton_chariots}	해골 전차
{cst_deck_droppers}	갑판 침투꾼
{cst_deck_droppers_handguns}	갑판 침투꾼 (소총)
{cst_deck_droppers_bombers}	갑판 침투꾼 (폭탄 무장)
{cst_deck_gunners}	갑판 포수
{cst_ror_zombie_pirate_gunnery_mob_handguns_full}	검은 반점 (좀비 해적 사수 무리 - 소총)
{cst_scurvy_dogs}	괴혈병 걸린 개
{cst_ror_necrofex_colossus_full}	교수대 거인 (네크로펙스 거신)
{cst_ror_necrofex_colossus}	교수대 거인
{cst_ror_deck_gunners_full}	그림자망령 포수 (갑판 포수)
{cst_ror_deck_gunners}	그림자망령 포수
{cst_necrofex_colossus}	네크로펙스 거신
{cst_count_noctilus}	녹틸루스 백작
{cst_carronades}	단신 함포
{cst_animated_hulks}	되살아난 덩치
{cst_ror_rotting_prometheans_gunnery_mob_full}	램프리 호의 복수단 (부패한 프로미디언 사수 무리)
{cst_ror_rotting_prometheans_gunnery_mob}	램프리 호의 복수단
{cst_luthor_harkon}	루터 하콘
{cst_ror_mournguls_full}	밤의 공포 (아귀 떼)
{cst_ror_mournguls}	밤의 공포
{cst_vampire_fleet_captain}	뱀파이어 함대 선장
{cst_vampire_fleet_captain_vampires}	뱀파이어 함대 선장(뱀파이어)
{cst_vampire_fleet_captain_deep}	뱀파이어 함대 선장(심연)
{cst_vampire_fleet_captain_death}	뱀파이어 함대 선장(죽음)
{cst_vampire_fleet_admiral}	뱀파이어 함대 제독
{cst_vampire_fleet_admiral_vampires}	뱀파이어 함대 제독(뱀파이어)
{cst_vampire_fleet_admiral_deep}	뱀파이어 함대 제독(심연)
{cst_vampire_fleet_admiral_death}	뱀파이어 함대 제독(죽음)
{cst_vampire_fleet_admiral_pistol_vampires}	뱀파이어 함대 제독(권총 - 뱀파이어)
{cst_vampire_fleet_admiral_pistol_deep}	뱀파이어 함대 제독(권총 - 심연)
{cst_vampire_fleet_admiral_pistol_death}	뱀파이어 함대 제독(권총 - 죽음)
{cst_vampire_fleet_admiral_polearm_vampires}	뱀파이어 함대 제독(폴암 - 뱀파이어)
{cst_vampire_fleet_admiral_polearm_deep}	뱀파이어 함대 제독(폴암 - 심연)
{cst_vampire_fleet_admiral_polearm_death}	뱀파이어 함대 제독(폴암 - 죽음)
{cst_rotting_leviathan}	부패한 리바이어던
{cst_rotting_prometheans}	부패한 프로미디언
{cst_rotting_prometheans_gunnery_mob}	부패한 프로미디언 사수 무리
{cst_bloated_corpse}	불어터진 시체
{cst_sartosa_militia}	사르토사 민병대
{cst_sartosa_free_company}	사르토사 용병대
{cst_syreens}	사이린
{cst_cylostra_direfin}	사일로스트라 다이어핀
{cst_ror_deck_droppers_bombers_full}	소금 군주 패거리 (갑판 침투꾼 - 폭탄)
{cst_ror_deck_droppers_bombers}	소금 군주 패거리
{cst_ror_zombie_pirate_deckhands_mob_full}	스키욜드의 물결 (좀비 해적 갑판원 무리)
{cst_ror_zombie_pirate_deckhands_mob}	스키욜드의 물결
{cst_depth_guard}	심연 근위대
{cst_depth_guard_polearms}	심연 근위대 (도끼창)
{cst_mournguls}	아귀 떼
{cst_mourngul_haunter}	아귀령
{cst_aranessa_saltspite}	아라네사 솔트스파이트
{cst_queen_bess}	여왕 베스
{cst_damned_paladin}	저주받은 성전사
{cst_damned_questing_knights}	저주받은 수행 기사
{cst_damned_knights_of_the_realm}	저주받은 왕국의 기사
{cst_damned_knigts_errant}	저주받은 편력 기사
{cst_zombie_pirate_deckhands_mob}	좀비 해적 갑판원 무리
{cst_zombie_pirate_deckhands_mob_polearms}	좀비 해적 갑판원 무리 (도끼창)
{cst_zombie_pirate_gunnery_mob}	좀비 해적 사수 무리
{cst_zombie_pirate_gunnery_mob_handguns}	좀비 해적 사수 무리 (소총)
{cst_zombie_pirate_gunnery_mob_hand_cannons}	좀비 해적 사수 무리 (총통)
{cst_zombie_pirate_gunnery_mob_bombers}	좀비 해적 사수 무리 (폭탄)
{cst_death_shriek_terrorgheist}	죽음의 비명 테러가이스트
{cst_gunnery_wight}	포수 망령
{cst_ror_depth_guard_full}	핏빛 약탈자 갑판 경비병 (심연 근위대)
{cst_ror_depth_guard}	핏빛 약탈자 갑판 경비병
{all_great_vortex}	대와류
{all_vortex}	와류
{hef_ulthuan}	울수안
{bst_brayherd}	포효의 무리
{bst_herdstone}	무리돌
{bst_blood_ground}	핏빛 땅